@@@@@@@@@.@@@@@@@.@@@@@@@@@@.@@@@@@@@@@@@@@@@@@@@@@@@@@@@@@@@@@@@@.@@@@@@@@@@@@.@@@@@.@@@@@@@@@@@@@*
@.............................@.............................@...................@@@.......@.........
@.............................@.............................@...................@@@.......@.........
@.............................@.............................@...................@@@.......@.........
..............................@.............................@.............................@.........
@...................@@@@@@@@@@@.............................@.............................@.........
@...................@@@@@@@@@@@.............................@.............................@.........
@...................@@@@@@@@@@@.............................@.............................@.........
@.............................@.........@...................@.............................@.........
@.............................@.............................@.............................@.........
@.............................@...........................................................@.........
@.............................@.............................@...................@.........@.........
@...........................................................@...................@.........@.........
@.............................@.............................@...................@.........@.........
@.............................@.............................@...................@.........@.........
@.............................@.............................@...................@.........@.........
@.............................@.............................@...................@.........@.........
@.............................@.............................@...................@...................
@...................@.........@.............................@...................@.........@.........
....................@.........@.............................@.............................@.........
@@@@@@@@@@@@@@@@@@@@@@@@@@@@@@@@@@@@@@@@@@@@@@@@@@@@@@@@@@@@@@@@@@@@@@@@@@@@@@@@@@@@@@@@@@@@@@@@@.@@
@.............................@.............................@...................@@@.......@.........
@.............................@.............................@...................@@@.......@.........
@.............................@.............................@...................@@@.......@.........
..............................@.............................@.............................@.........
@...................@@@@@@@@@@@.............................@.............................@.........
@...................@@@@@@@@@@@.............................@.............................@.........
@...................@@@@@@@@@@@.............................@.............................@.........
@.............................@.........@...................@.............................@.........
@.............................@.............................@.............................@.........
@.............................@...........................................................@.........
@.............................@.............................@...................@.........@.........
@...........................................................@...................@.........@.........
@.............................@.............................@...................@.........@.........
@.............................@.............................@...................@.........@.........
@.............................@.............................@...................@.........@.........
@.............................@.............................@...................@.........@.........
@.............................@.............................@...................@...................
@...................@.........@.............................@...................@.........@.........
....................@.........@.............................@.............................@.........
@.@@@@@@@@@@@@@@@@@@@@@@@@@@@@@@@@@@@@@@@@@@@@@@@@@@@@@@@@@@@@@@@@@@@@@@@@@@@@@@@@@@@@@@@@@@@@@@@@@@
@.............................@.............................@...................@@@.......@.........
@.............................@.............................@...................@@@.......@.........
@.............................@.............................@...................@@@.......@.........
..............................@.............................@.............................@.........
@...................@@@@@@@@@@@.............................@.............................@.........
@...................@@@@@@@@@@@.............................@.............................@.........
@...................@@@@@@@@@@@.............................@.............................@.........
@.............................@.........@...................@.............................@.........
@.............................@.............................@.............................@.........
@.............................@...........................................................@.........
@.............................@.............................@...................@.........@.........
@...........................................................@...................@.........@.........
@.............................@.............................@...................@.........@.........
@.............................@.............................@...................@.........@.........
@.............................@.............................@...................@.........@.........
@.............................@.............................@...................@.........@.........
@.............................@.............................@...................@...................
@...................@.........@.............................@...................@.........@.........
....................@.........@.............................@.............................@.........
@@@@@@@@@@@@@@@@@@@@@@@@@@@@@@@@@@@@@@@@@@@@@@@@@@@@@@@@@@@@@@@@@@@@@@@@@@@@@@@@@@@@@@@@@@@@@@@@@.@@
@.............................@.............................@...................@@@.......@.........
@.............................@.............................@...................@@@.......@.........
@.............................@.............................@...................@@@.......@.........
..............................@.............................@.............................@.........
@...................@@@@@@@@@@@.............................@.............................@.........
@...................@@@@@@@@@@@.............................@.............................@.........
@...................@@@@@@@@@@@.............................@.............................@.........
@.............................@.........@...................@.............................@.........
@.............................@.............................@.............................@.........
@.............................@...........................................................@.........
@.............................@.............................@...................@.........@.........
@...........................................................@...................@.........@.........
@.............................@.............................@...................@.........@.........
@.............................@.............................@...................@.........@.........
@.............................@.............................@...................@.........@.........
@.............................@.............................@...................@.........@.........
@.............................@.............................@...................@...................
@...................@.........@.............................@...................@.........@.........
....................@.........@.............................@.............................@.........
@.@@@@@@@@@@@@@@@@@@@@@@@@@@@@@@@@@@@@@@@@@@@@@@@@@@@@@@@@@@@@@@@@@@@@@@@@@@@@@@@@@@@@@@@@@@@@@@@@@@
@.............................@.............................@...................@@@.......@.........
@.............................@.............................@...................@@@.......@.........
@.............................@.............................@...................@@@.......@.........
..............................@.............................@.............................@.........
@...................@@@@@@@@@@@.............................@.............................@.........
@...................@@@@@@@@@@@.............................@.............................@.........
@...................@@@@@@@@@@@.............................@.............................@.........
@.............................@.........@...................@.............................@.........
@.............................@.............................@.............................@.........
@.............................@...........................................................@.........
@.............................@.............................@...................@.........@.........
@...........................................................@...................@.........@.........
@.............................@.............................@...................@.........@.........
@.............................@.............................@...................@.........@.........
@.............................@.............................@...................@.........@.........
@.............................@.............................@...................@.........@.........
@.............................@.............................@...................@...................
@...................@.........@.............................@...................@.........@.........
....................@.........@.............................@.............................@.........
@@@@@@@@@@@@@@@@@@@@@@@@@@@@@@@@@@@@@@@@@@@@@@@@@@@@@@@@@@@@@@@@@@@@@@@@@@@@@@@@@@@@@@@@@@@@@@@@@.@@